WWW--WWW
W------W
W------W
---M----
--------
W------W
W------W
WWWPPWWW