WWWWW--WWWWW
W----------W
W-----M----W
W----------W
W----------W
-----WW-----
-----WW-----
W----------W
W----------W
W------HH--W
W----------W
WWWWW--WWWWW