WWW--WWW
W------W
W------W
--------
--------
W------W
W------W
WWWPPWWW